....................O.....................................
....O...............O......RU3..........................O.
......................... X3*4............................
.........................  4RU............................
................................................RU3.......
.......RU3.................................... X3*4.......
..... X3*4....... X3RU...............O........  4RU.......
.....  4RU.......  4E3..............3RU...................
...................RU4..............4*3 X.................
....................................RU4  .................
............................O.............................
.........................................OO...............
............................RU3...........................
.......................... X3*4..A.............3RU........
...O.............O........  4RU..... X....... X4*3........
....................................  .......  RU4........
....3RU.............................3RU...................
....4*3 X.......RU3 X...............4*3...................
....RU4  .......3*4  ...............RU4...................
................4RU.......................................
..........................................................
..........................................................