*..O.OO...*3...O.O..O...*> .OO....W.OOO*O.W..O....OO......
.OO.....*O.4..O.*...O....3.O....O.3.O.....> ..O..O..OO..O.
...A.O...O.3..O..O.O*..OO4......O.4.....O.3..O..O.....O...
.....O.....4..O.O......OO3RU3.....3....O..4OO..........O*O
........O..3.....OO....O.4OO4*....4*..O.O.3....3RU&RU3.OOO
..*....O...4*O......  O. <OO3..3RU3.O...O.4**..4.. O.4....
..OOOO.....3RURURURURURURUO*4..4W34.O...O.RURURU..O..RURUN
..O......O.4..OO*O..W..O..O.3..RU43..O....3*...3.....W*OOO
*......O...3......O.> .O..O.4.....4......O4..OO4O.O.O3OOEO
O......O...4.O.O....3...O.O.3RU3..3....O..3....3O.O.O4OOOO
...O*...O.*3*.....*.4*OO....43L4..4. .O..*4.O..4O.O.O3....
RU&WRU&RURU4O....OO.RURURURUW4RU..RU^RURURU....3O.O.O4..O.
*..... *W......O....3.*O..........W.....3...O..4.....3.O*O
....O...3**O.O......4....OO.O.O.O.3.O...4O.... <.....4....
..O.....4.....O.*. .3............*4...O.3O..O..3.....3...O
..*..O..RURURURURU^W4RU3RU&RURURURU.....4*.O...4..*..4.O..
..O....O3.....O....OO.*4.. O.O.........O3......WRU#RUW...O
....*.O.4O.....O....OO.3...O..O..*..O...4.O.*..O.*3.O.....
...OO...W.O..O..O......4.O*.......O....O3...O...O.4..O...O
....O..O> .O...O*O...O.3........O.......4........O> ..*.O.
.O......3...O..OO....O.4..O.....O..OO.O.3.....OO..3..OO...
*...O..*4*...O......O..L*..O..O.......O*4*.O......4.O....*