..OO......................................................
............O............O................................
...................................O......................
..........................................................
..............................................OO..........
...RURU3...3RURU.O.RURU3...3RURU...RURU3...3RURU...RURU3..
...3...4...4O*O3...3...4...4***3...3  X4...4*.*3...3O**4..
...4.E.3...3O**4...4L*N3...3*.*4...4***3...3.*.4...4O**3..
...3...4...4**O3...3...4...4***3...3***4...4*.*3...3O**4..
...4RURU...RURU4...4RURU...RURU4...4RURU...RURU4...4RURU..
..........................................................
...................................O......................
....O..O........*O...OO.O.O......................O...O....
....O*....O.....O...........O.......*O...*....O......*....
.O...O......O...............O.O.O..OO....O...O.*....OO.O..
.O.....O..................................................
..*.O....O*O....O.....................O..O.....O.....O....
.O........O.......X. .X. .X. .X. ................O...O....
....O..O....O..*O. .X. .XO .X. .X....O...............*..O.
.O............OO...................O.....O*O...O..O..O..O.
.*O........*.......OOO.....O............O...............O.
...............................A.........................*