 <*********# +++++++%%%#####+++++++    *     #A           
%3OOOOOOOOO# ++++++++%%    #        +++++ ++  ########### 
%4OOOOOOOOO# +++++++++ #####5++++++ ++X XXX+X    ++++ ++# 
%3OOOOOOOOO#&#++.%++++ #   +      + +X    X++X   XX XX +# 
%4OOOOOOOOO# #++*.++++ #   ++++++ + ++ +X XX       +++ X# 
%3OOOOOOOOO#&#+###++## # +        + +++X+X+  +    XX X+ # 
%4OOOOOOOOO# #+#++##+# # ++++++++++  ++ X+X+XX    +X++X # 
%3OOOOOOOOO#&#+#++++## #X         ++ +     XX  +       +# 
%4OOOOOOOOO# #+#+++### #+++^+++++  + + +XX   ++       * 2 
%#OOOOOOOOO#&##+##++## #+++ ++++++&+ + +++XX X++++++  #+# 
&OOOOOOOOOO# #+++++++# #+X       + + ++X X+X+X  X X+   +# 
 OOOOOOOOOO#&+#L.876+# #++++++^+++ + ++++      X  ++   +# 
...........# +#9CBRU++ #+X   + < + +    +X  +++ ++    XX# 
           #&++#WL#8#+ #+^++ +*+ + + +++++ + +        XX# 
           # ++P2227#+ #+  +  ++ + + ++++* 2 +        +X# 
           #&#+.L7.9+# #++ +     + +    ++++ +  XXXXXXXX# 
+          # ++3W3P6++ ##+X+++++++ + ++      +  XX+XXXXX# 
+          #&++454RU++++#+         + ++++++++###X+XXX+XX# 
+          # ++#6C.P++++##+++++    +           #X+XXX+XX# 
E          #&++RUP9L9++++#####+++++++++++++++# #XXX+XXX## 
+          # ++L98638++%%% < ################# #########+ 
+          < RUWPP74P+++++++  < < < < <                   