.O*.......3.....RUO.O...*.*.3.O..+*...O....*+...*..+.E....
.+D...D...4.O..O+O..*+OO...34.**.++.*.....*+.OOOOOO+.....+
..D...D..O..*O..+.*....*RU.4...*.O+O..*.OO+.O.*....+....+O
..*...D.....O..*+O..+.*..OO#O..O...+...O.+..O...O.*+...+.*
.......D...O....+..OO..O+*.#*.....D+...*+......*..*+..+*..
......D.D.O*.O..RU..**RU.*.#..O....+..O+%.OO.*O.OO.+++....
++++.D..*.+OO....RU.+.*..+....*.*.O+.O+..O....*..O..O..O..
.*.+..A...+...O..%3O....O.*#O......+*+....*.O..O..O**....O
...++++++++O.....34*.O.*...#+++++++..#.O.*..O.O..*.O.O.*..
O..O.*..+..**...34......+O.#*...O..**#*.O..O..OO.O..*...O.
*..O.....+...+++4RURUO###3##O..*.*O..#....OO......*O....O.
...*.O*...++++O.*.. 3.*.*4...OL#O*..O#++++++++.O.O....O*O.
+++...O..*.+.O.O O..4...O3. O+#*#.**.#D.*......*....O..*..
..++D......+..+RU.ORU.*..4. +#..#.OO*#*...OO....OOOO.**O.O
D...++..++++..O.3.*.> O.RU*RU..O######...O..O**.........*.
*..O+.++*.O...*.4O..RURU....OO....O.....O...*....O...O....
..O..D+....*O...3*....*3OOO.........O..O..*.OD..DDDDDDDDDD
.O*...+O..O*..RU4.O.3..4***..OO..O.*O.O..*..O..DO.......O.
O....*+D...OOO3.*...4RU3.O..*.*.O...OO.*...O...D..*...O..*
+++++++....*O.4.O.O...O4RU.*....*...O.*...O.RURUOO..OO.*..
O.O.O..O*.O...3.O..*3*O *3.OOO....*.OO..OO..3..3*.....O...
*.............4.*.O.4..O 4......OO*O..OO....4*.4..O.*...*.