..............................
.                            .
.                            .
.                            .
. +           Y            + .
. .+                      +. .
. ..+            A       +D. .
. ...+                  +.Y. .
. ..M.+                +.... .
. .....+              +..6.. .
. ...9..+            +...... .
. .......+          +....... .
. ........+        +........ .
. ........+       +........  .
. ..   ....+     +.........  .
. .. . .....+   +..........  .
.............+O+... ..........