..............................
.                            .
.                            .
.             D              .
. +      .....Y            + .
. .+     .                +. .
. ..+            A       + . .
. ...+                  +. . .
. ..M.+                +.... .
. .....+              +..6.. .
. ...9..+            +...... .
. .......+          +....... .
. ........+        +........ .
. ........+       +........  .
. ..   ....+     +.........  .
. .. . .....+   +..........  .
.............+O+... ..........