##############################
#                            #
#                            #
#  ************************  #
# +************************+ #
# .+**********************+. #
# ..+********************+D. #
# ...+******************+.Y. #
# ..M.+****************+.... #
# .....+**************+..6.. #
# ...9..+************+...... #
# .......+**********+....... #
# ........+********+........ #
# ........+*******+........  #
# ..* *....+*****+.........  #
# ..*.*.....+***+..........  #
# ...........+*+...........  #
#             .              #
#      A                     #
#                            #
#                            #
#                            #
#                            #
#                            #
#                            #
#                            #
#                            #
#                            #
#                            #
# .......................... #
#                            #
#                            #
#                           Z#
##############################