######
#...5#
#.A..#
#....#
######