##############################
#                            #
#                            #
#                            #
# +                        + #
# .+                      +. #
# ..+                    +D. #
# ...+                  +.Y. #
# ..M.+                +.... #
# .....+              +..6.. #
# ...9..+            +...... #
#O.......+          +.......O#
#O........+        +........O#
#O........+       +........OO#
#O..OOO....+OO OO+.........OO#
#O..O.O.....+OOO+..........OO#
#............+ +... .........#
#             .   ...        #
#          OA     . .   . .  #
#      ............ .   .X.  #
#    D .    X    . .    ..   #
#    . ............X.        #
#                 ...        #
#                  .         #
#        %                   #
#                            #
#                            #
#                            #
#                            #
# ...........    ........... #
#                            #
#                            #
#YYYYYYYYYYYYYYYYYYYYYYYYYYYZ#
##############################