..............................
.                            .
.      &              >      .
.      .      D              .
. +      .....Y       <    + .
. .+     .          .     +. .
. ..+            A  5    + . .
. ...+       F    ^ .   +. . .
. ..M.+      .         +.... .
. .....+          ^   +..6.. .
. ...9..+   .2.      +...... .
. .......+          +....... .
. ........+        +........ .
. ........+       +........  .
. ..   ....+     +.........  .
. .. . .....+   +..........  .
.............+O+... ..........