######
#...5#
#.A.^#
#...&#
######