##########################
#...5....................#
#........................#
#.A.^....................#
#...&....................#
#........................#
#........7.......1.......#
#............8...........#
#...9....................#
#........................#
##########################