##########################
#...5....................#
#........................#
#.A.^....................#
#...&....................#
#........................#
#................1.......#
#........................#
#........................#
#........................#
##########################