##############################
#                            #
#                            #
#  ************************  #
# +************************+ #
# .+**********************+. #
# ..+********************+D. #
# ...+******************+.Y. #
# ..M.+****************+.... #
# .....+**************+..6.. #
# ...9..+************+...... #
# .......+**********+....... #
# ........+********+........ #
# ........+*******+........  #
# ..* *....+*****+.........  #
# ..*.*.....+***+..........  #
# ...........+*+...........  #
#            D.              #
#      A                     #
#                            #
#                            #
#                            #
#                            #
#                            #
#                            #
#                            #
#                            #
#                            #
#                            #
# ...........    ........... #
#                            #
#                            #
#YYYYYYYYYYYYYYYYYYYYYYYYYYYZ#
##############################