##########################
#...5.........2....L...%.#
#......................C.#
#.A.^.......&...P......B.#
#...&......W...........D.#
#...............N......Y.#
#..M.....7.......1.......#
#............8........6..#
#...9............F.......#
#..........<...>.........#
##########################