##########################
#...5..................%.#
#......................C.#
#.A.^..................B.#
#...&..................D.#
#......................Y.#
#........7.......1.......#
#............8...........#
#...9............F.......#
#........................#
##########################